wwwww
wtywtyw
w w www
wpr  krw
wwdrwwww
w  r  w
w  rf w
w  r  w
wwwwwww
LEVEL 9