wwwwwwwww
wpr r r w
wr r r rw
w r r r w
wr r r  w
w r r rfw
wwwwwwwww
LEVEL 10