wwwwwwwwwwwww
w ty w tr w tb w
w p w   w   w
w   w   w   w
w   w   w   w
w tr w tb w ty w
wwwwww wwwwww
    w f w
    wwwww
LEVEL 11